!!ATOK_TANGO_TEXT_HEADER_1
!!一覧出力
!!単語種類;登録単語(*) 自動登録単語($)
!!読み範囲;(読みの先頭) → (読みの最終)
!!出力日時;14/03/28 11:47


!!艦娘名
あおば	青葉	固有一般*	艦隊これくしょん
あかぎ	赤城	固有一般*	艦隊これくしょん
あかし	明石	固有一般*	艦隊これくしょん
あかつき	暁	固有一般*	艦隊これくしょん
あがの	阿賀野	固有一般*	艦隊これくしょん
あきぐも	秋雲	固有一般*	艦隊これくしょん
あきつまる	あきつ丸	固有一般*	艦隊これくしょん
あけぼの	曙	固有一般*	艦隊これくしょん
あさしお	朝潮	固有一般*	艦隊これくしょん
あしがら	足柄	固有一般*	艦隊これくしょん
あたご	愛宕	固有一般*	艦隊これくしょん
あぶくま	阿武隈	固有一般*	艦隊これくしょん
あまつかぜ	天津風	固有一般*	艦隊これくしょん
あやなみ	綾波	固有一般*	艦隊これくしょん
あらしお	荒潮	固有一般*	艦隊これくしょん
あられ	霰	固有一般*	艦隊これくしょん
い１６８	伊168	固有一般*	艦隊これくしょん
い１９	伊19	固有一般*	艦隊これくしょん
い５８	伊58	固有一般*	艦隊これくしょん
い８	伊8	固有一般*	艦隊これくしょん
いかずち	雷	固有一般*	艦隊これくしょん
いく	伊19	固有一般*	艦隊これくしょん
いすず	五十鈴	固有一般*	艦隊これくしょん
いせ	伊勢	固有一般*	艦隊これくしょん
いそなみ	磯波	固有一般*	艦隊これくしょん
いなづま	電	固有一般*	艦隊これくしょん
いむや	伊168	固有一般*	艦隊これくしょん
うしお	潮	固有一般*	艦隊これくしょん
うづき	卯月	固有一般*	艦隊これくしょん
うらかぜ	浦風	固有一般*	艦隊これくしょん
う゛ぇーるぬい	Верный	固有一般*	艦隊これくしょん
おおい	大井	固有一般*	艦隊これくしょん
おおしお	大潮	固有一般*	艦隊これくしょん
おおよど	大淀	固有一般*	艦隊これくしょん
おぼろ	朧	固有一般*	艦隊これくしょん
かが	加賀	固有一般*	艦隊これくしょん
かげろう	陽炎	固有一般*	艦隊これくしょん
かこ	加古	固有一般*	艦隊これくしょん
かすみ	霞	固有一般*	艦隊これくしょん
きくづき	菊月	固有一般*	艦隊これくしょん
きさらぎ	如月	固有一般*	艦隊これくしょん
きそ	木曾	固有一般*	艦隊これくしょん
きたかみ	北上	固有一般*	艦隊これくしょん
きぬ	鬼怒	固有一般*	艦隊これくしょん
きぬがさ	衣笠	固有一般*	艦隊これくしょん
きりしま	霧島	固有一般*	艦隊これくしょん
くま	球磨	固有一般*	艦隊これくしょん
くまの	熊野	固有一般*	艦隊これくしょん
くろしお	黒潮	固有一般*	艦隊これくしょん
こんごう	金剛	固有一般*	艦隊これくしょん
ごーや	伊58	固有一般*	艦隊これくしょん
さかわ	酒匂	固有一般*	艦隊これくしょん
さざなみ	漣	固有一般*	艦隊これくしょん
さつき	皐月	固有一般*	艦隊これくしょん
さみだれ	五月雨	固有一般*	艦隊これくしょん
しょうかく	翔鶴	固有一般*	艦隊これくしょん
しょうほう	祥鳳	固有一般*	艦隊これくしょん
しきなみ	敷波	固有一般*	艦隊これくしょん
しぐれ	時雨	固有一般*	艦隊これくしょん
しまかぜ	島風	固有一般*	艦隊これくしょん
しらつゆ	白露	固有一般*	艦隊これくしょん
しらぬい	不知火	固有一般*	艦隊これくしょん
しらゆき	白雪	固有一般*	艦隊これくしょん
じゅんよう	隼鷹	固有一般*	艦隊これくしょん
じんつう	神通	固有一般*	艦隊これくしょん
すずかぜ	涼風	固有一般*	艦隊これくしょん
すずや	鈴谷	固有一般*	艦隊これくしょん
ずいかく	瑞鶴	固有一般*	艦隊これくしょん
ずいほう	瑞鳳	固有一般*	艦隊これくしょん
せんだい	川内	固有一般*	艦隊これくしょん
そうりゅう	蒼龍	固有一般*	艦隊これくしょん
たいげい	大鯨	固有一般*	艦隊これくしょん
たかお	高雄	固有一般*	艦隊これくしょん
たかさき	高崎	固有一般*	艦隊これくしょん
たつた	龍田	固有一般*	艦隊これくしょん
たにかぜ	谷風	固有一般*	艦隊これくしょん
たま	多摩	固有一般*	艦隊これくしょん
ちょうかい	鳥海	固有一般*	艦隊これくしょん
ちくま	筑摩	固有一般*	艦隊これくしょん
ちとせ	千歳	固有一般*	艦隊これくしょん
ちとせ	千歳甲	固有一般*	艦隊これくしょん
ちとせ	千歳航	固有一般*	艦隊これくしょん
ちよだ	千代田	固有一般*	艦隊これくしょん
ちよだ	千代田甲	固有一般*	艦隊これくしょん
ちよだ	千代田航	固有一般*	艦隊これくしょん
つるぎさき	剣埼	固有一般*	艦隊これくしょん
てんりゅう	天龍	固有一般*	艦隊これくしょん
とね	利根	固有一般*	艦隊これくしょん
なか	那珂	固有一般*	艦隊これくしょん
ながつき	長月	固有一般*	艦隊これくしょん
ながと	長門	固有一般*	艦隊これくしょん
ながなみ	長波	固有一般*	艦隊これくしょん
ながら	長良	固有一般*	艦隊これくしょん
なち	那智	固有一般*	艦隊これくしょん
なとり	名取	固有一般*	艦隊これくしょん
ねのひ	子日	固有一般*	艦隊これくしょん
のしろ	能代	固有一般*	艦隊これくしょん
はっちゃん	伊8	固有一般*	艦隊これくしょん
はぐろ	羽黒	固有一般*	艦隊これくしょん
はち	伊8	固有一般*	艦隊これくしょん
はつかぜ	初風	固有一般*	艦隊これくしょん
はつしも	初霜	固有一般*	艦隊これくしょん
はつはる	初春	固有一般*	艦隊これくしょん
はつゆき	初雪	固有一般*	艦隊これくしょん
はまかぜ	浜風	固有一般*	艦隊これくしょん
はるな	榛名	固有一般*	艦隊これくしょん
ひゅうが	日向	固有一般*	艦隊これくしょん
ひえい	比叡	固有一般*	艦隊これくしょん
ひびき	響	固有一般*	艦隊これくしょん
ひよう	飛鷹	固有一般*	艦隊これくしょん
ひりゅう	飛龍	固有一般*	艦隊これくしょん
ふそう	扶桑	固有一般*	艦隊これくしょん
ふぶき	吹雪	固有一般*	艦隊これくしょん
ふみづき	文月	固有一般*	艦隊これくしょん
ふるたか	古鷹	固有一般*	艦隊これくしょん
べっぷ	Верный	固有一般*	艦隊これくしょん
ほうしょう	鳳翔	固有一般*	艦隊これくしょん
まいかぜ	舞風	固有一般*	艦隊これくしょん
まきぐも	巻雲	固有一般*	艦隊これくしょん
まみや	間宮	固有一般*	艦隊これくしょん
まや	摩耶	固有一般*	艦隊これくしょん
みょうこう	妙高	固有一般*	艦隊これくしょん
みかづき	三日月	固有一般*	艦隊これくしょん
みくま	三隈	固有一般*	艦隊これくしょん
みちしお	満潮	固有一般*	艦隊これくしょん
みゆき	深雪	固有一般*	艦隊これくしょん
むさし	武蔵	固有一般*	艦隊これくしょん
むつ	陸奥	固有一般*	艦隊これくしょん
むつき	睦月	固有一般*	艦隊これくしょん
むらくも	叢雲	固有一般*	艦隊これくしょん
むらさめ	村雨	固有一般*	艦隊これくしょん
もがみ	最上	固有一般*	艦隊これくしょん
もちづき	望月	固有一般*	艦隊これくしょん
やましろ	山城	固有一般*	艦隊これくしょん
やよい	弥生	固有一般*	艦隊これくしょん
ゆうぐも	夕雲	固有一般*	艦隊これくしょん
ゆうだち	夕立	固有一般*	艦隊これくしょん
ゆうばり	夕張	固有一般*	艦隊これくしょん
ゆきかぜ	雪風	固有一般*	艦隊これくしょん
ゆら	由良	固有一般*	艦隊これくしょん
りゅうじょう	龍驤	固有一般*	艦隊これくしょん
RJ	龍驤	固有一般*	艦隊これくしょん
りゅうほう	龍鳳	固有一般*	艦隊これくしょん
わかば	若葉	固有一般*	艦隊これくしょん


!!兵装
こうかくほう	高角砲	固有一般*	艦隊これくしょん
こうひょうてき	甲標的	固有一般*	艦隊これくしょん
こうひょうてき	甲標的 甲	固有一般*	艦隊これくしょん
さんしきだん	三式弾	固有一般*	艦隊これくしょん
さんれんそうほう	三連装砲	固有一般*	艦隊これくしょん
だいはつ	大発動艇	固有一般*	艦隊これくしょん
だいはつどうてい	大発動艇	固有一般*	艦隊これくしょん
たんしんぎ	探信儀	固有一般*	艦隊これくしょん
そなー	聴音機	固有一般*	艦隊これくしょん
たんそうほう	単装砲	固有一般*	艦隊これくしょん
ちょうおんき	聴音機	固有一般*	艦隊これくしょん
てっこうだん	徹甲弾	固有一般*	艦隊これくしょん
でんたん	電探	固有一般*	艦隊これくしょん
とうしゃき	投射機	固有一般*	艦隊これくしょん
ばくらい	爆雷	固有一般*	艦隊これくしょん
ふんしんほう	噴進砲	固有一般*	艦隊これくしょん
れんそうほう	連装砲	固有一般*	艦隊これくしょん


!!艦載機
かごう	カ号	固有一般*	艦隊これくしょん
かごう	カ号観測機	固有一般*	艦隊これくしょん
さいうん	彩雲	固有一般*	艦隊これくしょん
しでん	紫電	固有一般*	艦隊これくしょん
しんでん	震電	固有一般*	艦隊これくしょん
しんでん	震電改	固有一般*	艦隊これくしょん
しんでんかい	震電改	固有一般*	艦隊これくしょん
すいかん	零式水観	固有一般*	艦隊これくしょん
すいせい	彗星	固有一般*	艦隊これくしょん
すいせい	彗星一二型甲	固有一般*	艦隊これくしょん
ずいうん	瑞雲	固有一般*	艦隊これくしょん
ずいうん	瑞雲(六三四空)	固有一般*	艦隊これくしょん
ずいうん	瑞雲(12型)	固有一般*	艦隊これくしょん
すつーか	Ju87C改	固有一般*	艦隊これくしょん
せいらん	晴嵐	固有一般*	艦隊これくしょん
ぜろ	零戦	固有一般*	艦隊これくしょん
ぜろ	零式水偵	固有一般*	艦隊これくしょん
ぜろ	零式水観	固有一般*	艦隊これくしょん
ぜろ	零式艦戦	固有一般*	艦隊これくしょん
ぜろせん	零戦	固有一般*	艦隊これくしょん
てんざん	天山	固有一般*	艦隊これくしょん
りゅうせい	流星	固有一般*	艦隊これくしょん
りゅうせい	流星改	固有一般*	艦隊これくしょん
れっぷう	烈風	固有一般*	艦隊これくしょん
れっぷう	烈風改	固有一般*	艦隊これくしょん
れっぷうかい	烈風改	固有一般*	艦隊これくしょん


!!艦種
けいくう	軽空	固有一般*	艦隊これくしょん
けいぼ	軽母	固有一般*	艦隊これくしょん
けいくうぼ	軽空母	固有一般*	艦隊これくしょん
けいじゅん	軽巡	固有一般*	艦隊これくしょん
けいじゅん	軽巡洋艦	固有一般*	艦隊これくしょん
こうせん	航戦	固有一般*	艦隊これくしょん
こうくうせんかん	航空戦艦	固有一般*	艦隊これくしょん
こうじゅん	航巡	固有一般*	艦隊これくしょん
こうくうじゅんようかん	航空巡洋艦	固有一般*	艦隊これくしょん
すいぼ	水母	固有一般*	艦隊これくしょん
すいじょうきぼかん	水上機母艦	固有一般*	艦隊これくしょん
せんすいくうぼ	潜水空母	固有一般*	艦隊これくしょん
せんぼ	潜母	固有一般*	艦隊これくしょん
じゅうじゅん	重巡	固有一般*	艦隊これくしょん
じゅうじゅん	重巡洋艦	固有一般*	艦隊これくしょん
らいじゅん	雷巡	固有一般*	艦隊これくしょん
じゅうらいそうじゅんようかん	重雷装巡洋艦	固有一般*	艦隊これくしょん


!!軍事用語
いごう	伊号	固有一般*	艦隊これくしょん
かんこう	艦攻	固有一般*	艦隊これくしょん
かんせん	艦戦	固有一般*	艦隊これくしょん
かんてい	艦偵	固有一般*	艦隊これくしょん
かんばく	艦爆	固有一般*	艦隊これくしょん
かんぽん	艦本	固有一般*	艦隊これくしょん
しせい	試製	固有一般*	艦隊これくしょん
しょうろう	檣楼	固有一般*	艦隊これくしょん
すいてい	水偵	固有一般*	艦隊これくしょん
すいかん	水観	固有一般*	艦隊これくしょん
たいせん	対潜	固有一般*	艦隊これくしょん
たんおう	単横陣	固有一般*	艦隊これくしょん
たんおうじん	単横陣	固有一般*	艦隊これくしょん
たんじゅう	単縦陣	固有一般*	艦隊これくしょん
たんじゅうじん	単縦陣	固有一般*	艦隊これくしょん
ていけい	梯形陣	固有一般*	艦隊これくしょん
ていけいじん	梯形陣	固有一般*	艦隊これくしょん
ていじ	丁字	固有一般*	艦隊これくしょん
ていじ	T字	固有一般*	艦隊これくしょん
てぃーじ	T字	固有一般*	艦隊これくしょん
どうこう	同航	固有一般*	艦隊これくしょん
どうこうせん	同航戦	固有一般*	艦隊これくしょん
はんこう	反航	固有一般*	艦隊これくしょん
はんこうせん	反航戦	固有一般*	艦隊これくしょん
ふくほう	副砲	固有一般*	艦隊これくしょん
ふくじゅう	複縦陣	固有一般*	艦隊これくしょん
ふくじゅうじん	複縦陣	固有一般*	艦隊これくしょん
ほうか	砲架	固有一般*	艦隊これくしょん
ほうとう	砲塔	固有一般*	艦隊これくしょん
りんけい	輪形陣	固有一般*	艦隊これくしょん
りんけいじん	輪形陣	固有一般*	艦隊これくしょん

!!作戦
あごう	あ号	固有一般*	艦隊これくしょん
いごう	い号	固有一般*	艦隊これくしょん
ろごう	ろ号	固有一般*	艦隊これくしょん

!!艦これ用語
かいに	改二	固有一般*	艦隊これくしょん
かんこれ	艦これ	固有一般*	艦隊これくしょん
かんむす	艦娘	固有一般*	艦隊これくしょん
ほうらいげき	砲雷撃	固有一般*	艦隊これくしょん
ほうらいげきせん	砲雷撃戦	固有一般*	艦隊これくしょん

